00011111001011000011000010011001101000000101001010001111111011010001101000010100
01000001011001111011000101001100000110111011010111101100010010101110011100100101
01011111111101111000001000100111000110011011100000000110100001010010101111000000
10010111001110000001000100110000111011111110101010000000010101111110110001110011
00001100010001111100110101110001011100000100000000001010111100011010110101111011
01001001101001101011111011101000011100101010111000111000110100110000100011010010
01000011111111101010010010001110010010000011101000011100110001000011010011110110
11011110001101101011110010011100010110000000010000101010110110010100001101100001
00000110100000100111011010010001001110010001100101100100110111100101000110110000
00110001100010101001011011111000010100011110001101001101011111111000000001100001
00011011000100110111111111001001101000000011011101111100111010001011110011010101
10000100010001001100111010101110010100111110101010111111010100101101100001000011
11011001010010100000110011110001101010010011101111100011000101101111001011011111
11100000100111101101000110001001011111100110010111011011010001110001011111010100
10001010100000011110011011110111011010101111110110100100010000011111100100110010
01101000011010100101000000100100110110010101111010100001110011011100011101011001
11001010110011100001010000111000111111000000001100101010101011001101100011110101
00111110011001101001000001111010011011011110100111000101011110001010001010010010
00111001100000101011011011001010111101011100000110000101001110010110101110001011
00110010100001100111001100011010101001111001010101100010100110111000010010001101
00001111100011101001101000100010010110001001110010110101111111000011100011010000
10000000011100110110000001011110000000111100010001011101110011000001110010000010
10000111011000000011011001011100011110111101110011111011100100000000110101111001
01111110010001011001111100000011001011110000011100001111101101011100011101010111
01110011000111101101000100000011000000001100101001110110010100101110000011100011